PPPP.PPP
P..1.PPP
PP..PPSP
PP.PP24P
P..PP.PP
P.PPP..P
P.3.PP.P
PPP.PP.P
PPP....P
PPPPPPPP